1111100000
1400100000
1033101110
1030101210
1110111210
0110000210
0100010010
0100011110
0111110000
0000000000