0111110000
0140111000
0103001000
1110101100
1210100100
1230010100
1200030100
1111111100
0000000000
0000000000