0011110000
0012210000
0110211000
0100321000
1103001100
1001330100
1004000100
1111111100
0000000000
0000000000