0001110000
0001210000
1111010000
1230311100
1114302100
0013111100
0012100000
0011100000
0000000000
0000000000