0001111110
0111000010
1120311011
1223030041
1220303011
1111110010
0000011110
0000000000
0000000000
0000000000