0111111100
0100000111
1131110001
1040300301
1022103011
1122100010
0111111110
0000000000
0000000000
0000000000