0111100000
1100100000
1430100000
1130110000
1103010000
1230010000
1225210000
1111110000
0000000000
0000000000