0001111111
0011001041
0010001001
0013030301
0010311001
1110301011
1222220010
1111111110
0000000000
0000000000