0011110000
1110011000
1022001110
1052500010
1433233010
1001100010
1111111110
0000000000
0000000000
0000000000